********************
*        *         *
*        *         *
*   1    *         *
*        *         *
*        *         *
*        *         *
*        *         *
*                  *
*                  *
*                  *
**********         *
*                  *
*                  *
*                  *
*         **********
*                  *
*               <  *
*                  *
********************
