********************
*                  *
*                  *
*         1        *
*                  *
*                  *
*                  *
*                  *
*                  *
*    ***********   *
*                  *
*                  *
*                  *
*                  *
*                  *
*                  *
*                  *
*               ^  *
*                  *
********************
